╔════════════┬════════════╗
║.P..........║............║
║.╔══╗.╔═══╗.║.╔═══╗.╔══╗.║
║*║``║.║```║.║.║```║.║``║*║
║.║``║.║```║.║.║```║.║``║.║
║.╚══╝.╚═══╝.║.╚═══╝.╚══╝.║
║.........................║
║.════.║.╔─────╗.║.══════.║
║......║.╚──┬──┘.║........║
╚════╗.║....║....║.╔══════╝
`````║.╚═══.║.═══╝.║```````
═════╝.............╚═══════
...........................
═════╗.............╔═══════
`````║.............║```````
╔════╝.............╚══════╗
║.........................║
║.........................║
║.........................║
║.........................║
║.........................║
║.........................║
║.........................║
║.........................║
║.........................║
║.........................║
║.........................║
║.........................║
╚═════════════════════════╝
