┌════════════┬════════════┐
║............║............║
║.┌══┐.┌═══┐.║.┌═══┐.┌══┐.║
║*║``║.║```║.║.║```║.║``║*║
║.║``║.║```║.║.║```║.║``║.║
║.╚══╝.╚═══╝.║.╚═══╝.╚══╝.║
║.........................║
║.════.║.┌─────┐.║...════.║
║......║.╚──┬──┘.║........║
╚════┐.║....║....║.┌══════╝
`````║.╚═══.║.═══╝.║```````
═════╝........P....╚═══════
...........................
═════┐.............┌═══════
`````║.............║```````
┌════╝.............╚══════┐
║.........................║
║.........................║
║.........................║
║.........................║
║.........................║
║.........................║
║.........................║
║.........................║
║.........................║
║.........................║
║.........................║
║.........................║
╚═════════════════════════╝
